lb	    I
lh  	I
lw		I
ld		I
lbu		I
lhu		I
lwu		I
addi    I
slli    I
slti  	I
sltiu 	I
xori 	I
srli 	I
srai 	I
ori 	I
andi 	I
auipc 	U
addiw 	I
slliw 	I
srliw 	I
sraiw 	I
sb 		S
sh		S
sw 		S
sd 		I
add 	R
sub 	R
sll 	R
slt 	R
sltu 	R
xor 	R
srl 	R
sra 	R
or 		R
and 	R
lui 	U
addw 	R
subw 	R
sllw 	R
srlw  	R
sraw 	R
beq 	SB
bne 	SB
blt 	SB
bge 	SB
bltu 	SB
bgeu 	SB
jalr 	I
jal 	UJ
mul		R
mulh	R
mulhsu	R
mulhu	R
div		R
divu	R
rem		R
remu	R
mulw	R
divw	R
remw	R
remuw	R
fall_through	E